111111111111111111111111111111111111
1.....P....1.......1.......1..1....1
1...1....1......1.....11..1....1.1.1
1....1...1.....1.1..1...1.1.11.1...1
1....1.......111.1...1...1.1.....1.1
1....1.1.11...1.1...1.1....1.1.111.1
1.1.1.1.1.1.1.1.1.1.1.1.1.1.1.1.1.11
1..................................1
1..................................1
1...1...1.1.111.1...1.1...1.1.1....1
1111111111111111111111111111111111.1
1................E...............E.1
1......1......1......1111111111....1
1......1......1..........1.........1
1......1......1..........1.........1
1......11111111..........1...E.....1
1......1......1..........1.........1
1......1......1..........1C........1
1......1......1......1111111111....1
1..................................1
1....................1.1...1.11..111
1.....11.........11................1
1.....11.........11.......1........1
11..............................1111
1.......1........1...111.1..1.1.1111
1........1......1.....111.11..1....1
1....1....1....1....1...1.1.1111..11
1..........1111.....1....1.111.1...1
1...1.111111.1...111.1.11..1.11.1.11
1....111111...1.1.1...1.1.11111.1.11
1.....11111...1.1.1.1.11111.1...E.11
.............1..1...................
.............1..1...................
.............1..1...................
.............1..1...................
.............1..1...................
.............1..1...................
.............1..1...................
.............1..1...................
.............1..1...................
.............1..1...................
.............1..1...................
.............1..1...................
.............1..1...................
.............1..1...................
.............1..1...................
11111111111111..111111111111111111111111111111111111
1..................................................1
1....1...............................E........1....1
1....1..................1111..................1....1
1....1..................1111..................1....1
1....1..................1111C.................1....1
1....1.....E..................................1....1
1....1....................................E...1....1
1....1........................................1....1
1..................................................1
1111111111111111111111111..1111111111111111111111111
........................1..1
........................1..1
........................1..1
........................1..1
........................1..1
........................1..1
........................1..1
........................1..1
........................1..1
........................1..1 
........................1..1                                                               
1111111111111111111111111..111111111111111111111111111111111111
1.............................................................1
1..E..........................................................1
1.............................................................1
1......1....1..1111111..1......1.......111111.................1
1......1....1..1........1......1.......1....1.................1
1......111111..11111....1......1.......1....1.................1
1......1....1..1........1......1.......1....1.................1
1......1....1..1111111..11111..111111..111111.................1                             11111111111111111111111111111111111111111111111111111
1........................E....................................1                             1...................................................1
1...................................................E.........1                             1................................E..................1 
1.............................................................1                             1.......1.......11111111..1.........................1 
1.............................................................1                             1.......1.......1......1..1.........................1 
1................E............................................1                             1.......1.......1......1..1.........................1    
1.............................................................1111111111111111111111111111111.......1.......1......1..1.........................1
1.....................1......................1111111111.............................................1.......1......1..1.........................1
1.....................11.....................1......................................................111111..11111111..111111....................1
1............................................1................1111111111111111111111111111111...................................................1
1............................................1................1                             1....................E..............................1
1............1111.........1111...............1................1                             1...................................................1
1.............11...........11................11111111.........1                             1...................................................1
1........1.......................1...........1................1                             1...................................................1
1........1.......................1...........1................1                             1........................E..........................1
1........1.......................1...........1................1                             1...................................................1
1........1..............1........1...........1................1                             11111111111111111111111111111111111111111111111111111
1........1..............1........1...........1111111111.......1
1........1..............1........1............................1
1........1.......................1............................1
1........1.............E.........1............................1
1........1.......................1..................E.........1
1........1.......................1............................1
1........1111111111111111111111111............................1
1.............................................................1
1.............................................................1
111111111111111111111111111111111111111111111111111111111111111