111111111111111111111111111111111111111111111111111111111111
1.1.11.1.P...1.111.1.1.1..1111.1...1..1..1..1.1..1.1...11.11
1.....111..1......1.1.11..1...1....1.....1.1...1111...1..111
11.11...11.111....1......1.1.11.1111....111.1.1111.11..111.1
1..1.1..1.1.11111.11.11.1111.11.1.11.1111.11.1.1.111..11.1.1
111.1.11.111.1...11.1.....1.1.111111111.1...111.11....111.11
1111.11..1.1.1.111111..E1...111..11..1.111.111..1..1...1..11
1111.1111.1..E..1.1..1.E..11.1.1.111111.1..1.11.11.1..111111
11.1.1..1..E.11..11..1..11.E..1.111.11.1..1.11.111...1...111
1...1111.111.11.1.1.1.1C.E1.1.E.1...11.11.11..11.11.11.1.1.1
1....1..1.1.1..1..1..E..11.1.1...1.11.11.11.1111.1111.111111
1.1.1....11111.11111...1111...111.1.1.11..1..11..1...1...111
111.11.1..1...1.11.1..11.11.E..E...11..1.111.1..1.1....1.111
1.1..1.1.1111.1.1..1.11.1..1.11.1.111111111..11..1..111.1.11
11.1....1...11..E.1...111.1111111...1111..11.11.11.11..111.1
1..11.1.E.1.1.1.111.11..1.1...1.11..1..1..11.11.1.1.1..1.111
1.11.11...111...1.11..11....11...111...1........1.111.1.1..1
1.11...1..E..1.1...11..1.111.1.1...11.1.11.11...........1111
1..1.1...E..1.....111111.1.1111.11....1.11...1.1.1..1..1..11
1.1.1.1.....11.1.1.111.11..1.1..1.1...1.111..111.1C..1.1...1
11111.11111.....1.1111.11111.1..1.11.1...11...1.......11.1.1
1..11.11...1..111.11.111111111..1...11.....1.1..111.1...11.1
1.1.1..111.1111.11.1.E.111.1.1....1...1.111111...11.11.11.11
1.111111..111..111111......1111.1.1.1.1..E...11....11....1.1
1111..11.11..11....1111..1..E...1....11......1..11..1.....11
11..111.1...11..111.1..1...1...1111.1..111..1..1...111...111
1111...E..1..11..11.111..E.1..111..E.1.1..1.1111.1..11.1.111
1..1.E..1.1.11.111..11.1.11.1.1.11.1111....1..111...111...11
1.1.11.111.111.11.11..1...111...1.1...11.11..111....1111...1
1....11111..1...11.1.11111.11...111.1111.....1...1..1..111.1
1..1111..11.11...E.11....1.1..1..1....1.1..1.1.1..1.11.....1
1111.111..11...1..11.1..1.1.1111..1111......1.1.1.11.1.....1
1111.1.1.11.1.111.11.111.1.1..11.1..E.11111.1.1111..111..1.1
11...1....111..1...E.....111..11111...1111.1111.111.11....11
11..1.1.11111...1..1....1111..11111.C..1.1.111..1....111..11
111.111..111.11111.1111.11..1.11....1..1..1.1..1..111..111.1
1..E..1.11111.1.1.11.E.11..1.E.1...11...E.1111111111..1.1..1
1..1.111111...11...11111..11.11.111.1.1...11..1...1111.11.11
1...11..E..111.1.1.1.11.1..1...1..1.1.1.11.111..1.1.1..1.1.1
1..111.111111.11.1.111.1.11.111111111....1.1...11111..111..1
11.1..11..11.1.1111...1..1..11.1.11.1.111.1111.1..111..11.11
1.11...11...11...11111...11.....1.1.11.1.1111.11..11.1.1.1.1
11....1..1111111.1.1.E..1.111C11.1..11111...1...E...11111111
1111.1..1..E..1111..11..1.11....E..1.1111.1...1....11......1
1.11.1.1.11.1.11111.....1....1.11.11.1..1111.111.1.1.1.1..11
1...11.1..1...11......1...11.....11.....1.1.1.1..1..1.1....1
11..11..11.11..111.11..1.111111..1111...11.1111..11..1.11.11
1.11111.1...1111...E...11111.1....11.1..1..11.111..11.1..1.1
11.1..111..C.11...111.11111.11.11..1111.1...1.11..1..11.1111
1..111....1111111..11....11..1.1111.1.1.11.....1..11111.1111
111111..11111..1.1.E..1.111.1.E.11111.1.11.1....E....1.111.1
111.....11.111...1111111.1.111.1..1111..11.11.111.1..11....1
1.1......1.11.1..111...1.1.........11....11.1.11.1.....111.1
111...11..1....11.111.....11...111.111..1111...1.1....1.11.1
1...11111.111.111....1....1..1..1.11.1111.1....1..1...1.1111
1..1...1.1111.11.1111111.1..111....1111.1..11..1..1..11.1..1
1....1..1.11.1..11111.1111...11.1111.111.1.11.1..11.11...1.1
1111.1..11...11.111.1.11...11.111111.111.11...11.1..11.1.111
11111..1....111.1111.1..1.1.1...11.1...11.1.1.1.1.1...111..1
11111111111111111111..1111111111111111..11111111111111111111
...................1..1..............1..1...................
...................1E.1..............1E.1...................
...................1..1..............1..1...................
...................1..1..............1..1...................
...................1.E1..............1.E1...................
...................1..1..............1..1...................
...................1..1..............1..1...................
...................1..1..............1E.1...................
...................1..1..............1..1...................
...................1..1..............1..1...................
11111111111111111111..1111111111111111..11111111111111111111
1111.1...E...1...1.1..11.111.11.11.11.1.....111111.11.1.1.11
11.111111111....1.1..1.111..E..11...11...1.11.1..1.111..11.1
1..111111..11.1.11.1..11..11.1.1..1.1.11..1111.1..1.....1.11
1...1111.11.11..1....11..1.1..1.111..E..11.1..11.1.111.11.11
111.111..11.E.1..11.11111.1111111111111C.1111111.111..111..1
1.1.1.1.111..1.1.1..11...E..11...1.1.E.11.E..1.11111..1..1.1
1.1..1.11...111.1..111..E...111.1..1.1111..E..111.1.1...11.1
1..........1.1.1.1.1111.11...1111.111....111111.11.1.1111.11
111.1.1..111..11...E..1.1111.11111.1.1..1..E.1.1...1..1.1.11
111...1.1.1.1.1...1...11.111..11...1.11...E.1.1.1.111...E..1
1.11.1111..11111111..1.1..1..1.1...1.11...11.1.1..1.1..11111
11.1.1111.1.1.1111....E.....E...111..1.11.1..11..11.1...1111
11111111.11.1..11111.111...1.1111...1...1.1.111...1.1..1...1
1..11...1111..1..1.1..1.1...E.1111.1...1..1111.11...1.111111
11.1.111.111.1111..11..1.1.E..1111111..1.1..111..1.1.1.E1111
1...11..11111111111.11111......1...1111.11.11.1....11.11.1.1
1..1111111.1C..1...11...111..1111.111.11111.1.....1.11...111
111.111.1.111..111111..E.11111.1..1..11...11..1...11..1.1.11
1.1.1...111..11.1..1..E.1...1...E..1111.111.1.11.1111.11..11
1111.111111.11..1.1111.111.1111.1.11111.1....1.1.1...1.111.1
111...11..1111..1.111..11..11...E...111..1.11..111..1..1..11
1.....1..11111C..1111.111..1.11.1.1.111..1..11....1.1..1..11
1.11...1111...E..1..111...1...1.11.1.1.1..11.111...111.1...1
111..1.111..1.111111..E..1..1.1..11.1.111.1..111.111.1...1.1
1111...1.1.111.1..1111111.11.E..1..1111..11.1.11..1.1..1.1.1
11111.1.1..111..1.11....11.1...111..1..11.11....1....1.1.1.1
111..1.1.1..11111..1.1..11.1111.111...11..11.1....1.111.1..1
111.1..1C.E.1.1.1.1.11..1.1...1.1...1111..1.11..11..11..11.1
11.11...1.11...11.1..111.11.11..1..1.111.11.1111..1111.1.1.1
111111.11111.11.111..1111111..11...11...1...1..11...111...11
1.111..1..E..1.11.11.1.....11.1111111....1.1.111...11..11.11
11.1111...1.1111..1..11.1..1.11..1.11..111111.E..E...1..1111
11....1..1..1C..1..1.1...11.11..1..11111.......1.11...1....1
1.1...111..1...1.1.111..11111..1.1..111..1.11111.....E.1.111
1111..1..11.11..1...11.1111111..1.1..11.11.....1.11111.1.1.1
1.11.....1....1...11111111.11..11...11......1........111.111
111........1...1.11.1.11..1111.....1.11.1.1...11.1.1..1.1.11
1111..1..1111..1.11.111..1.11.1...1.1.11..1..11.111...1.1..1
1.1..1........1....11111111..1.1...1.....1.1..1.1111...1..11
1...11.11.1...1.1.111..11.1......1.11..1.1.11..11...1...1.11
1.11.1.11..1.1.1.1....11....11.....11..1111..1.....1.1111..1
11.11111111111.1..1111C........111.11.1.111..11.1...11.1.111
1.1.111...11..11...11...1111..11..1.111....1.11.1.1.1.1..111
1.1.1....1111.1..11.1.1...1...11.1..11..1....1.1.11..11..1.1
111....111.11.1...111111.111.1.11.1....1.1111..11..1...11111
11........11.1.1.111..111.1.111111..1.1.1...1111...111..11.1
111..11.1111.1.11..11.11.111...1.1.1.11.11.1..1.11.1.....1.1
1111.1111111...111.1..1..1111.1.1...1...1111...1.1111.111111
1.1.11..11111..E..11.11.1..111.1.1.1111.1...1111.11...1.1.11
11...11.111.1......1.1...11...11.11.1....111.11.1.1...111..1
11..111....11111.11111.1....E.1..1..1..1.111.11111...1.1.111
11....111.111111.1..11..11..1...1......1..1.1..11.11.1.11..1
1..111....1...11..1111..1..11111.11.11.111....11.11.1.1.1111
1.11.111..1.11..1...1111111111.1.11...11.111..1.1111.1.1..11
11.....1.1..11.1...1.11111..1.1..1...1..1..1..11.111.11.1111
1.1..1111...11.1.111..1.11..1..1.111111.1.11.11...111.11..1111111111111111111111111111111111111
11.1.1....11.111....1..111111..1.1.1..1...111.111.1.1.1.1.1...........E................E......1
1.11....1111..1.1111.111.......1......111....111..1.1.........E................E..............1
11111111111111111111111111111111111111111111111111111111111111111111111111111111111111111111111