11111111111111111111111111111111111111111111111111
1111111P..111..11.11.1.1......111111..1..111111..1
1.....11...1111111.1..11.1.11...111.11.1.11..111.1
1.11.1..1..11..11.11.1...11111......1.11.111.....1
1..1.....1111.1.11.....1..11.1111..1......1111.111
11..11.1.1111..11..1.11111..111..11...1..1....1.11
111.1..11.1.1...11..1.11.1..1.11.....1111...1...11
111.1...11111...111111.111111.1.1.1111.1.1...1.111
11...111111.11..111..1.111.11.1....11.1.11.1.111.1
1...1.11.11..1..1111.1.1.1.1.1.1.11.1..1.1.1111..1
111111.1..1.......1111...11.....1.1.1..1..111..111
1.1.11....111...1111111111.11....11.111111.1.11111
1111.1.1.1.E.11...1.111.11...11...111.11.1....1.11
1....11.1..1..11.1111.1.11...11111.1..111111.1...1
1.1..E.1..11C..E1...1..1..11.1...1.1.11.1.1..1.111
11.111....E...111..11......111...1.1...1.11.11.111
111...11..11.11.111...1.1111...11..11.1.1.....11.1
1..11..11111...1....1111..E..1.11.11111.1.11.11..1
11..1....1.11.11.11...1.1.....1.1.1.1....111.1...1
1.1....111.11.11..1.1.1.1..E.1.1.111.11.11..11.1.1
11...1...11.1.E11..111....E.1..1....1111.111.1.1.1
1111....1.1...1...11.111.1111...1.1.1..1..11....11
11.1.1.1.1.....11E.11..1111.E.1.1...1....111...111
11111.11111.1.11...1111C..11.1.11.11..1111111..111
1.1.11.1.1111.1......E...1.11..1..1..1.11.1111.1.1
1..11...1.1.11..1.1.11.111.1.111.....1...1.1.1..11
1.11.11...1...11.1....1.....E...E..111.1.1111..1.1
1111..1.111..1....111.111.11..1.11..1.1....11.11.1
1111..1.11...11.111.1..1..1.1..111.111....11..11.1
11.1.111.111.11.11.E..111....1.1111...11.111.1.1.1
11.1.11.1...1.11......11.11.11111.1.1..11.1.1111.1
11....1.1..1...11.1.1111..11111.11.11.11.1.111.1.1
11..1...E..1..11.E...1.E..11111.11..1.....1..1..11
1...11..1..1.11..1.11..1...11.1.......1.11..1.11.1
1..1....11111.11.1.11..1.....11.1.11.1..111.1..111
1111.111.111..1.....1.E..1.11..1.1.11111..1.....11
1111...1..111.....11.1.1.1..1...1..111.1111..1.1.1
11.......1E..111..1..11.1...1111.1.1E.11.1..1.1..1
1111....11...1111.11.1...1..11..11..111.111.1..111
1111111111..11111111111111111111111..1111111111111
.........1..1.....................1..1............
.........1E.1.....................1..1............
.........1..1.....................1..1............
.........1..1.....................1..1............
.........1E.1.....................1..1............
.........1..1.....................1..1............
.........1..1.....................1..1............
.........1..1.....................1..1............
1111111111..11111111111111111111111..111
1111111.1..1..11...1..1.1....111...11..1
111...11.111..11..11.1.111111....1..1.11
1.1......1..1.11111..1..1111.....11.1111
111.1.11.1.1.E.1..1....11..1..1...111.11
111..11.11.1..1.11.1...1.11..1.11...1..1
11.111..E..1111...E.111111...1..1.1111.1
1.1.1.111..1.11.1.1C..1..1...11...11..11
111...1.1..11.....1.1..111111E...1....11
11.11..11.......1.1.1...11.1.1111.111111
11......111.1...1..1..1.11111..1...11..1
111...1..1.11.11111.111..1111.11..1111.1
11.11.E..1111..1...111..1.111....1.11..1
11.1..11...1.1...111..1..111C11.1.1.11.1
1.11...1.1..1111.1111111.1111...1.111.11
11E...111.11....1.1.111.1.11..111...1..1
111111...1...1..1111..11....11.1.1..11.1
11.1.11111.11.1.1.E.111111.1.E..1.1...11
11.11....11...111.11.1.111.111.11.1.1.11
11.111...1.1.1...11...11.1..111111...111
111.1.11...111.111111.11.1111.1.1......1
1.11.11...1....111.1111..1..11..1.1....1
1.1..1.111.1.11..1...1.1.....11.....11.1
1111111..11111..11..111..11.1....1.1.1.1
1.1.1.1..1.1.11.111..1..1.....1.1....1.1
111.1....11..1.....11.1...1.11..1111.111
1111.11..11111.11..1..1.1.1111...1...1.1
1..11.111.1..1.1...1111111.11...1...1.11
1111.11.11.11..1.1.11.1.1.1111.1.11.1..1
1...1.1..111.1.....11.111..1.111.1.....1
1.111.11.1111.1..1.1.11.111.1.111....1.1
1.111...111....1....11..1.1..1..1111..11
1.....1.1.1........1.11......1.1.1.1.111
1.111..1.1...11....1...111..1..1....1111
11..1.11...1111...11.111.1....11..1..1.1
1...1...1.11....1.1.....1.1.1.1111..1..1
111.11.11...11.1.11..1..11.1..1.11....11
1111111.111...11111.11.11111111.11111..1
111....1111.1.11.1111.11.1.1...111.1..11
1111111111111111111111111111111111111111